######
#    #
#    #
#    #
#X   #
######
